рубзик      - рубль
рубас
рубасик
рэс
тнавик      - tnav
челик       - человек
сотыга      - сто рублей
шестихот    - шестьсот рублей
пихот       - пятьсот рублей
приколюха   - шутка
видяха      - видео
ролдор      - ?????
вибранул    - завибрировал (о телефоне)
мафака      - чёрт
шапон       - шапка
шапонский 
шарфон      - шарф
душанский   - душ
ешка        - exp
паблос      - паблик
изейше      - просто
джидибишка  - дебаг версия
пушкануть   - сделать git push
погрехи     - погрешности
слешок      - /
штукет      - штука
чипсанские  - чипсы
эклипсянкий - slb ecl
лобанский   - лоб
подождь     - подожди
аудюха      - машина марки Ауди
ничошно     - неплохо
скобенция   - скобка
